Naked Skin Weightless Complete Coverage Concealer|Urban Decay|Stick|Matte
Creaseless Under Eye Concealer|tarte|Powder|Matte
Bye Bye Under Eye Illumination™ Full Coverage Anti-Aging Waterproof Concealer|IT Cosmetics|Stick|Natural
Beyond Perfecting Foundation + Concealer|CLINIQUE|Stick|Natural
Flawless Fusion Ultra Longwear Concealer|Laura Mercier|Powder|Radiant
Under Eye Brightening Corrector|BECCA|Stick|Natural
Aquacealer Concealer - Rainforest of the Sea™ Collection|tarte|Liquid|Radiant
Bye Bye Under Eye™ Full Coverage Anti-Aging Waterproof Concealer|IT Cosmetics|Stick|Matte
Amazonian Clay Waterproof 12-Hour Concealer|tarte|Stick|Natural
BAREPRO® 16-Hr Full Coverage Concealer|bareMinerals|Stick|Matte
BARESKIN® Complete Coverage Serum Concealer|bareMinerals|Powder|Radiant
Boi-ing Industrial Strength Concealer|Benefit Cosmetics|Liquid|Natural
Secret Concealer|Laura Mercier|Stick|Matte
Broad Spectrum Concealer|bareMinerals|Liquid|Matte
Under Eye Corrector|Bobbi Brown|Stick|Natural
Bye Bye Breakout™ Full-Coverage Concealer|IT Cosmetics|Cream|Radiant
Secret Camouflage|Laura Mercier|Stick|Natural
Boi-ing Hydrating Concealer|Benefit Cosmetics|Stick|Radiant
MAQUICOMPLET - Complete Coverage Concealer|Lancôme|Stick|Radiant
Double Wear Stay-In-Place Flawless Wear Concealer|Estée Lauder|Cream|Matte
bareminerals® Correcting Concealer Broad Spectrum SPF 20|bareMinerals|Powder|Radiant
Teint Idole Ultra Wear Camouflage Concealer|Lancôme|Powder|Matte
Boi-ing Brightening Concealer|Benefit Cosmetics|Powder|Natural
Colored Clay CC Undereye Corrector|tarte|Liquid|Matte
Creamy Concealer Kit|Bobbi Brown|Powder|Natural
Aqua Luminous Perfecting Concealer|BECCA|Liquid|Natural
Instant Full Cover Concealer|Bobbi Brown|Cream|Matte
Intensive Skin Serum Concealer|Bobbi Brown|Cream|Natural
All Nighter Waterproof Full-Coverage Concealer|Urban Decay|Liquid|Matte
Boi-ing Airbrush Concealer|Benefit Cosmetics|Liquid|Matte
Beyond Perfecting Super Concealer Camouflage + 24-Hour Wear|CLINIQUE|Liquid|Natural
Mister Light Instant Light Corrective Pen|Givenchy|Cream|Natural
Ultimate Coverage Longwear Concealer|BECCA|Cream|Matte
High Precision Retouch|Giorgio Armani Beauty|Stick|Natural
Candleglow Concealer and Highlighter|Laura Mercier|Liquid|Radiant
All About Eyes Concealer|CLINIQUE|Stick|Radiant
Line Smoothing Concealer|CLINIQUE|Liquid|Radiant
Airbrush Concealer Illuminates, Perfects|CLINIQUE|Liquid|Radiant
Retouching Face Pencil|Bobbi Brown|Powder|Radiant
Intensive Skin Serum Corrector|Bobbi Brown|Stick|Natural
Studio Skin 24 Hour Waterproof Concealer|Smashbox|Cream|Matte
Acne Solutions Clearing Concealer|CLINIQUE|Cream|Radiant
Double Wear Waterproof All Day Extreme Wear Concealer|Estée Lauder|Powder|Matte
Beyond Perfecting Powder Foundation + Concealer|CLINIQUE|Liquid|Radiant
The POREfessional: Pore Minimizing Makeup|Benefit Cosmetics|Cream|Matte
Compact Cream Concealer|Giorgio Armani Beauty|Powder|Radiant
Pore Refining Solutions Instant Perfector|CLINIQUE|Liquid|Matte
Teint Couture Embellishing Concealer|Givenchy|Powder|Natural
Hide & Sheen Concealer and Highlighter Duo|Benefit Cosmetics|Stick|Matte
